1111111111111111111111111111111111
1P000C00000C000C00000C00000E000001
10100101001000001010010C0000010101
10100100101010000010010C0000010101
110C00000C00CC000000C00000000000C1
1111111111111111111111111111111111