1111111111111
10000100000C1
1000011111001
1P0011100E001
1111111111111