1111111111111
10C0000011001
10C00P000E0C1
1111111111111