1111111111111
1P000000000C1
1000011111001
100000100E001
1111111111111